name: Test Sector
sprint_par: 90000
sweep_par: 200000
###################################
#S...............................T#
#.###############################.#
#.#.............................#.#
#.#.#########################.#.#
#.#.#.......................#.#.#
#.#.#.###################.#.#.#
#.#.#.#.................#.#.#.#
#.#.#.#.###############.#.#.#.#
#.#.#.#.#BBBBB#.......#.#.#.#.#
#.#.#.#.#BBBBB#.......#.#.#.#.#
#.#.#.#.#BBBBB#.......#.#.#.#.#
#.#.#.#.#BBBBB#.......#.#.#.#.#
#.#.#.#.#BBBBB#.......#.#.#.#.#
#.#.#.#.###D###.......#.#.#.#.#
#.#.#.#...........A...#.#.#.#.#
#.#.#.#################.#.#.#.#
#.#.#...................#.#.#.#
#.#.#######################.#.#
#.#.........................#.#
#.#############################.#
#...............................#
#################################
#################################
#################################
#################################
#################################
###################################
